0 0 3 4 6
0 1 0 1 1
0 1 2 0 0
0 1 0 1 0
0 0 5 1 5